TextMap0.texmap
map:
0001000000000000000000000000000000000000
0000000000000000000000100000000000000000
0000000000000000000000000000000000000000
0000000000000000000000000010000000000000
0000000000001000000000000000000000000000
0000000000000000000000000000000000000000
0000100000000000000000000000000000000000
0000000000000001000000000010000000000000
0000000000000000000010000010000000000000
0000000000000000000000000010000000000000
0000000000000000000000000000000000000000
0000001111111111111111111100000000000000
0000001000000000000000000000000000000000
0000001000000000000000000000000000000000
0000001111110000000010000000000000000000
0000000000000000000000000000022200000000
0000000000000000000000000000022222200000
0000000000000033333300000000000000000000
0000001000000000000000000000001000000000
0000001000000000000000000000000000000000
0000001000000000000000000000000000000000
0000000000000000000000000000000000000000