TextMap0.texmap
map:
3331333333333333333333332333333333333333
0000000000000000000000100000000000000003
0000000000000000000000000000000000000003
0000000000000000000000000010000000000003
0000000000001000000000000000000000000003
0000000000000000000000000000000000000003
0000100000000000000000000000000000000003
0000000000000001000000000010000000000003
0000000000000000000010000010000000000002
0000000000000000000000000010000000000003
0000000000000000000000000000000000000003
0000001111111111111111111100000000000003
0000001000000000000000000000000000000003
0000001000000000000000000000000000000003
0000001111110000000010000000000000000003
0000000000000000000000000000022200000003
0000000000000000000000000000022222200003
0000000000000033333300000000000000000003
0000001000000000000000000000001000000003
0000001000000000000000000000000000000000
0000001000000000000000000000000000000000
3333333333333333333333333333333333333333