TextMap0.texmap
map:
3331333333333333333333332333333333333333333133333333333333333333233333333333333333333333333333333333333333333333333333333333333333333333333333333333333333333333
0000000000000000000000100000000000000000000000000000000000000000000000000000000000000000000000000000000000000000000000000000000000000000000000000000000000000003
0000000000000000000000100000000000000000000000000000000000000000000000000000000000000000000000000000000000000000000000000000000000000000000000000000000000000003
0000000000000000000000100000000000000000000000000000000000000000000000000000000000000000000000000000000000000000000000000000000000000000000000000000000000000003
0000000000000000000000100000000000000000000000000000000000000000000000000000000000000000000000000000000000000000000000000000000000000000000000000000000000000003
0000000000000000000000000000000000000000000000000000000000000000000000000000000000000000000000000000000000000000000000000000000000000000000000000000000000000003
0000000000000000000100000000000000000000000000000000000000000000000000000000000000000000000000000000000000000000000000000000000000000000000000000000000000000003
0000000100000000000000000000000000000000000000000000000000000000000000000000000000000000000000000000000000000000000000000000000000000000000000000000000000000003
0000000000000000000000000000000000000000000000000000000000000000000000000000000000000000000000000000000000000000000000000000000000000000000000000000000000000003
0000000000000000000000000000000100000000000000000000000000000000000000000000000000000000000000000000000000000000000000000000000000000000000000000000000000000003
0000000000000000000000100000000000000000000000000000000000000000000000000000000000000000000000000000000000000000000000000000000000000000000000000000000000000003
0000000000000000000000100000000000000000000000000000000000000000000000000000000000000000000000000000000000000000000000000000000000000000000000000000000000000003
0000000000000000000000000100000000000000000000000000000000000000000000000000000000000000000000000000000000000000000000000000000000000000000000000000000000000003
0000000100000000000000000000000000000000000000000000000000010000000000000000000000000000000000000000000000000000000000000000000000000000000000000000000000000003
0000000000000000000000100000000000000000000000000000000000000000000000000000000000000000000000000000000000000000000000000000000000000000000000000000000000000003
0000000000000000000000100000000000000000000000000000000000010000000000000000000000000000000000000000000000000000000000000000000000000000000000000000000000000003
0000000000000000000000000100000000000000000000000000000000000000000000000000000000000000000000000000000000000000000000000000000000000000000000000000000000000003
0000000000000100000000000000000000000000000000000000000001000000000000000000000000000000000000000000000000000000000000000000000000000000000000000000000000000003
0000000000000000000000100000000000000000000000000000000000000000000000000000000000000000000000000000000000000000000000000000000000000000000000000000000000000003
0000000000000000000000100000000000000000000000000000000011000000000000000000000000000000000000111000000101000000000000000000000000000000000000000000000000000003
0000000000000000000000000100000000000000000000000000000000000000000000000000000000000000000000000000000000000101110000001000000000000000000000000000000000000003
0000000000000000000000000000000000000000000000000000000000011000000000000000000000010000010000000000000000000000000000000000000110000000000000000000000000000003
0000000000000000000000100000000000000000000000000000000000000000101010101011000000000000000000000000000000000000000000000000000000000100000000000000000000000003
0000000000000000000000100000000000000000000000000000000000000000000000000000000000000000000000000000000000000000000000000000000000000000010000000000000000000003
0000000000000000000000100000000000000000000000000000000000000000000000000000000000000000000000000000000000000000000000000000000000000000000000000000000000000003
0000000000000000000000000100000000000000000000000000000000000000000000000000000000000000000000000000000000000000000000000000000000011111000000000000000000000003
0000000000000000000000000000000000000000000000000000000000000000000000000000000000000000000000000000000000000000000000000000223200000000000000000000000000000003
0000000000001000000000000010000000000000000000000000000000000000000000000000000000000000000000000000000000000000000000000000000000000000000000000000000000000003
0000000000000000000000000000000000000000000000000000000000000000000000000000000000000000000000000000000000000000000000111000000000000000000000000000000000000003
0000100000000000000000000000000000000000000000000000000000000000000000000000001000000000000000000000000000001111000000000000000000000000000000000000000000000003
0000000000000001000000000010000000000000000000000000000000000000000000000000000000001000000000000000010000111000000000000000000000000000000000000000000000000003
0000000000000000000010000010000000000000000000000000000000000000000000000001000000000000010000000000010000000000000000000000000000000000000000000000000000000003
0000000000000000000000000010000000000000000000000000000000001111111110000000000000000000000000000000000000000000000000000000000000000000000000000000000000000003
0000000000000000000000000000000000000000000000010001100000000000000000000000000000000000000000000010000000000000000000000000000000000000000000000000000000000003
0000001111111111111111111100010000000111111110000000000000000000000000000000000000000000000001000010000000000000000000000000000000000000000000000000000000000003
0000001000000000000000000000000000000000000000000000000000000000000000000000000000111111100000000000000000000000000000000000000000000000000000000000000000000003
0000001000000000000000000000000010000000000000000000000000000000000000000000001111111111110000000000000000000000000000000000000000000000000000000000000000000003
0000001111110000000010000010000000000000000000000000000000000000000000000000000000000000000000000000000000000000000000000000000000000000000000000000000000000003
0000000000000000000000000000022200000000000000000000000000000000000000000000000000000000000000000000000000000000000000000000000000000000000000000000000000000003
0000000000000000000000000000022222200001100000000000000000000000000000000000000000000000000000000000000000000000000000000000000000000000000000000000000000000003
0000000000000033333300000000000000000100000000000000000000000000000000000000000000000000000000000000000000000000000000000000000000000000000000000000000000000003
0000001000000000000000000000001000000003000000000000000000000000000000000000000000000000000000000000000000000000000000000000000000000000000000000000000000000003
0000001000000000000000000000000000100000001000000000000000000000000000000000000000000000000000000000000000000000000000000000000000000000000000000000000000000003
0000001000000000000000000000000000000000000000000000000000000000000000000000000000000000000000000000000000000000000000000000000000000000000000000000000000000003
3333333333333333333333333333333333333333333333333333333333333333333333333333333333333333333333333333333333333333333333333333333333333333333333333333333333333333